__###___
__#.#___
__# ####
###$ $.#
#. $@###
####$#__
___#.#__
___###__
