______#####
__#####.#.#
###---....#
#--$-##-#-#
#-----$-#-#
##----$##-#
_#--#-$@$-#
_##-##$#--#
__#----####
__######___
