_______#_______
_____#####_____
___### @ ###___
___#  $ $  #___
___# *.*.* #___
__## .$ $. ##__
_### *.*.* ###_
####  $ $  ####
___######  #___
____##___##____
