_______####
____####@-#
#####---.-#
#---$*$-*-#
#----.-####
#####--#___
____####___
