_________#############_
_________#-.---------#_
_________#-#-######--#_
________##-*-##___#-##_
_______##--*--##__#-#__
______##--*-*--##_#-#__
____###--*-*-*--###-#__
######--*-*-*-*--##-###
#------*-*-*-*-*------#
#-#.#**$*$*@*$*$**#.#-#
#------*-*-*-*-*------#
###-##--*-*-*-*--######
__#-###--*-*-*--##_____
__#-#_##--*-*--##______
__#-#__##--*--##_______
_##-#___##-*-##________
_#--######-#-#_________
_#---------.-#_________
_#############_________
