___#####___
__##.--##__
__#---$-##_
_##$-##--##
##@-###---#
#..$---##-#
###$---#--#
_#---#-#--#
_#----.---#
_##########
