__####__
__#..#__
_## .##_
_#  $.#_
## $  ##
#  #$$ #
#  @   #
########
