#####____
#@  #____
# $$#_###
# $ #_#.#
### ###.#
_##    .#
_#   #  #
_#   ####
_#####___
