____#######
#####--..-#
#---------#
#--$.###--#
###$-######
__#--#@#___
__##-$-#___
_###$$-#___
_#.--.-#___
_#######___
