____#######
#####--.--#
#---$@.##-#
#---##-##-#
##--#-----#
_###-$.-#-#
__#---$---#
__#--##---#
__#--######
__####_____
