___#######
__##  # @#
__#   #  #
__#$ $ $ #
__# $##  #
### $ # ##
#.....  #_
#########_
