____#####_
___##---#_
####-$--#_
#--$---##_
#--@$###__
###.$.####
__#----..#
__########
