___######_
_###    #_
##. $## ##
#..$ $  @#
#.. $ $ ##
######  #_
_____####_
